2222222222222222
2111111111111112
2111111111111112
2111211111121112
2111211111121112
2112211111122112
2112111111112112
2111111111111112
2111111111111112
2111111111111112
2112111111112112
2112111111112112
2112111111112112
2112222222222112
2111111111111112
2222222222222222
