2222222222222222
2111111111111112
2121112221112212
2122111211122212
2112211211222112
2112221212222112
2112222222222112
2112121212121112
2111111111111112
2112222222222112
2112222222222112
2111111111111112
2112211111122112
2112111111112112
2111111111111112
2222222222222222
