22222222222222222222
21122112211221122112
21121111111111112112
21111111111111111112
21111111111111111112
21122111111111122112
21112211111111221112
21112221111112221112
21111222111122211112
22222222211222222222
21111222211222211112
21112222000022221112
21122220000002222112
21111111111111111112
22222222222222222222
