22222222222222222222
20022002200220022002
20020000000000002002
20000000000000000002
20000000000000000002
20022000000000022002
20002200000000220002
20002220000002220002
20000222000022200002
22222222200222222222
20000222200222200002
20002222000022220002
20000010000001000002
20000000000000000002
22222222222222222222
