2222222222222222
2111111111111112
2111111111111112
2112211211122112
2112211211122112
2112211211122112
2112211211122112
2111111111111112
2111111111111112
2112222222222112
2112222222222112
2111111111111112
2112211111122112
2111111221111112
2111111111111112
2222222222222222
