22222222222222222222
22112112111121121122
22000000000000000022
22001111111111100022
22200000000000000222
22110000000000001122
22110000011000001122
22222222222222222222
22000010000001000022
22221020101012102222
22220120000002102222
22200100000001100222
21001110000001110012
21000220000002200012
22222222222222222222
